NO ./xpmfiles/42.xpm
SO ./xpmfiles/amontign.xpm
WE ./xpmfiles/correcteur.xpm
EA ./xpmfiles/syakovle.xpm

F 100,100,100
C 100,100,190

        1111111111111111111111111
        10000000001100000000000001
        10110000011100000000000001
        1001000000000000000000001
111111111011000001110000000000001
10000000001100000111011111111111111111
111101111111110111000000100000000000001
111101111111110111010100100000000000001
11000000110101011100000010101111111111
10000000000000000000000000001
10000000000000001101010010N01
1100000111010101111101111000111
11110111 1110101 101111010001
11111111 1111111 1111111 1111