NO ./xpmfiles/42.xpm
SO ./xpmfiles/amontign.xpm
WE ./xpmfiles/beaugosse.xpm
EA ./xpmfiles/syakovle.xpm

F 100,100,100
C 100,100,190

        1111111111111111111111111
        10000000001100000000000001
        10110000011100000000000001
        1001000000000000000000001
111111111011000001110000000000001
100000000011000001110111111111111
11110111111111011100000010001
11110111111111011101010010001
11000000110101011100000010101
10000000000000000000000000001
10000000000000001101010010001
11000001110101011111011110E0111
11110111 1110101 101111010001
11111111 1111111 1111111 1111                    
   
